.~..~~~..~~~~......~...
.~...~~..~~~.......~...
.~.~..~........~~..~...
.~~~..........~~~~.~...
.~~~........~~~~~..~...
.~~...~~....~~~....~...
.~~...~~~..........~~..
.~....~~~..~~~~......~.
...2...~~...~~~~~..~.4.
.~........~H..~~~~.~~.~
........1.~~....~~.~.3~
.~~.~~~~..~~.......~.~.
.~........~~~...0....2.
.~.4.5.~...~~~.....~...
.~.....~~~~~~~.....~.1~
.~~~~~~~~~~~~~~~~~~~~..
.~5CCCCCCCCCCCCCCC3~.0.
.~~~~~~~~~~~~~~~~~~~.~.
~~~~~~~~~~~~~~~~~~~~~~~