~.~~~~~~
~~H~....
~.......
~.~~...~
~.~~...~
.......~
.......~
.~.~...~