~.~~~~~~
~~H~....
~.......
~.~~...~
~.~~C.C~
.....C.~
....C.C~
.~.~...~