~.~~.~~~~..~.~~
~......~......~
~...~~.~..~...~
~......~.~~~..~
..~~...~..~....
~......~......~
~......~....~..
...~~..~...~~~.
~......~....~.~
~.........~...~
....~~.~.~~~...
.~~....~..~...~
.......~......~
~...0..~..0.H.~
~......~......~
~......~......~
~~.~~~~~~~~~.~~