~~~~.~~.~~~.~
~.~..........
~.~.~~~~..~..
~2..........~
~~~~~~~~~.~~~
~2~..........
..~...~~~...~
~1........~..
~~~~~~~~~~~.~
~1~..........
~.~.H..~...~.
~0....~~.~...
~~~~~~~~~~~~~
~0~........~.
~.~.~...~.G..
~.....~.~....
~~~~.~~~~.~.~