~~S~~.~~~.~
~~....~~~..
...~~.~S~.~
~~~~S......
~~S~~.~C~.~
.....H.....
~~~.~.~~.~~
~SS.~.S~...
~S~.~.~~S~.
~.~......~~
....~.~....
~~~.~.~.~~~