~~..~~~.~~~~
~C.C.......~
..C......~..
.C.C~~..~~.~
~.~.~~.....~
~..........~
....~.~~...~
~...~~H~....
~...........
~.....~~...~
..~~..~~C.C~
~.~......C.~
~.......C.C~
~.~~.~.~...~