~~~~~~~~~...~...~~~~~
~~~~~~~~~........~~~~
~~~~~~~~~.........~~~
~~~~~~~~.....~~~~..~~
~~~~~~~.....~~~~~~..~
~~~~........~~~~~~...
............~~~~~~...
............~~~~~~...
....~~~~.....~~~~...~
...~~~~~~...........~
~..~~~~~~.H..........
~..~~~~~~............
~~.~~~~~~............
~~..~~~~........~~~..
~~........~~...~~~~~.
~........~~~~..~~~~~.
~........~~~~..~~~~~.
...~~~~~..~~....~~~..
..~~~~~~~............
.~~~~~~~~~.....~~~~..
.~~~~~~~~~....~~~~~~.