~~~~~~~~~~~~~~~~~~~
~CCC0~CC~C~~~~~~...
~CCC~~CC~C~~~~~...~
~CCC~1CC~C2~~....~~
~~~~~~~~~~~~...2.~~
~.......~....~...~~
...~~~~.....~~....~
..~~~~~...~~~~~....
~.~~~~....~~~~.....
~.~~~......~~~..~..
~...~.....H....~~~.
~..............~~~~
...1..~~....~..~~~~
~....~~~~..~~~..~~.
~~.~~~~~~..~~~.....
~~..~~~~~..~~......
............0.....~
~~.......~~......~~
~~~~..~.~~~~~~...~~