..~~.~.~.~..~~.~.....~~.~..~~.
.~...~.~.~~......~.~....~.~..~
...........~~.~.~..~..~...~~.~
...~~....~..~......~..~.~~~.~.
~~....~.~~......~....~........
............~~~~~.~~.....~~.~.
~..~H...~....~~...~.~..~...~..
.~~~....~~.......~~~..~......~
.~~..~.~~..~.~..........~....~
....~~.....~~..~...~~...~~....
~........~~~...~......~~....~.
~...~.~~.~.~...~~~.~...~~~.~.~
~..~.....~....~~~.~...~.~~....
~~.~....~~~~.....~~.~......~~.
~~~~.~~~~~~~.~~..~..~.~~~~.~.~